Ameerpet : BGMPT, Punjagutta, MDHN, S.R Nagar, 
Assembly : Lakdi-ka-pul, Nampally, 
BGMPT : Ameerpet, Parade Ground, 
Balanagar : Kukatpally, Moosapet, 
Bharat Nagar : Moosapet, Erragadda, 
Dilsuknagar : Musarambagh, Chitanyapuri, 
ESI Hospital : Erragadda, S.R Nagar, 
Erragadda : Bharat Nagar, ESI Hospital, 
Gandhi Bhavan : Nampally, Osmania Medical College, 
Gandhi Hospital : Musheerabad, Secundrabad West, 
Irrum Manzil : Punjagutta, Khairatbad, 
JBS : Parade Ground, 
JNTU College : KPHB Colony, 
KPHB Colony : JNTU College, Kukatpally, 
Kukatpally : KPHB Colony, Balanagar, 
LB Nagar : Victoria Memorial, 
Lakdi-ka-pul : Khairatbad, Assembly, 
MDHN : Ameerpet, 
MG Bus Stand : Osmania Medical College, Sultan Bazar, Malakpet, 
Malakpet : MG Bus Stand, New Market, 
Moosapet : Balanagar, Bharat Nagar, 
Musheerabad : RTC X Road, Gandhi Hospital, 
Nampally : Assembly, Gandhi Bhavan, 
Narayanguda : Chikkadpally, Sultan Bazar, 
New Market : Malakpet, Musarambagh, 
Osmania Medical College : Gandhi Bhavan, MG Bus Stand, 
Parade Ground : Secundrabad West, JSB, SCE, BGMPT, 
Punjagutta : Ameerpet, Irrum Manzil, 
RTC X Road : Chikkadpally, Musheerabad, 
S.R Nagar : ESI Hospital, Ameerpet, 
SCE : Parade Ground, 
Secundrabad West : Gandhi Hospital, Parade Ground, 
Sultan Bazar : MG Bus Stand, Narayanguda, 
Victoria Memorial : Chitanyapuri, LB Nagar, 
